NO assets/end_bricks4.xpm
SO assets/stonebrick_mossy.xpm
EA assets/stonebrick.xpm
WE assets/mud_bricks.xpm
F 132,192,200
C 195,224,244

        1111111111111111111111111
        1000000000110000000000001
        1001000001110000000000001
        10010000000000000000000011
111111111011000001110000000100001D1
1000000000110000011101111101111111
11110111111111011100000010001
111111111111111111111111111111
                                 11111111111
                                 111111111111
                                  11111111
11111111111111111111111111111111
10000000000000000000000000000001
10000000000000000000000000000001
1000000000000000N000000000000001
10000000000000000000000000000001
10000000000000000000000000000001
10000000000000000000000000000001
11111111111111111111111111111111

