C assets/sky_powder.xpm
F assets/end_bricks.xpm
NO assets/end_bricks.xpm
SO assets/stonebrick_mossy.xpm
EA assets/stonebrick.xpm
WE assets/mud_bricks.xpm

1111111111
1000000001
10000W0001
1000000001
1111111111