C assets/nether_brick.xpm
F assets/end_bricks.xpm
NO assets/end_bricks.xpm
SO assets/stonebrick_mossy.xpm
EA assets/stonebrick.xpm
WE assets/mud_bricks.xpm

1111111111111
1111101111111
1000101000001
1000000010001
10000E0000001
1111111111111