F 132,192,200
C 195,224,244
X assets/armor_stand.xpm
XL assets/steve.xpm
NO assets/end_bricks4.xpm
SO assets/stonebrick_mossy.xpm
EA assets/stonebrick.xpm
WE assets/mud_bricks.xpm
DD assets/doors_dark_oak.xpm

1111111111111
1111101111111
1000101000001
1000000010001
10000E1L00X01
111000L000001
10L0000000001
1011000000001
111L11D1L1111
1000000000001
1000000001001
1010100000001
1001010100011
1000111010101
100001X001001
1111111111111
