F 2,5,2
C 255,255,255
X assets/steve1.xpm
XL assets/steve2.xpm
XXL assets/steve3.xpm
NO assets/end_bricks4.xpm
SO assets/stonebrick_mossy.xpm
EA assets/stonebrick.xpm
WE assets/mud_bricks.xpm
DD assets/doors_dark_oak.xpm





1111111111111
1111101111111
1000101000001
1000000010001
1000001000X01
11100000X0001
10000N0000001
1011000000001
1110110101111
1000000000001
1000000001001
1010100000001
1001010100011
1000111010101
100001X001001
1111111111111

