		111111111111
 1111111100000000001
11000000000000000011
1000000000000000001
1111111111111111111


llll
l111l
l101l
l111l
llll