C 255,255,255
F 213,52,123
NO assets/end_bricks.xpm
SO assets/stonebrick_mossy.xpm
EA assets/stonebrick.xpm
WE assets/mud_bricks.xpm


	1111111111111111
 1111111100000000001
11000000000000000001
10000000000N0000001
1111111111111111111
1111111111111111
1000000000000001
1111111111111111