C 0,255,255
F 213,52,123
NO assets/end_bricks.xpm
SO assets/stonebrick_mossy.xpm
EA assets/stonebrick.xpm
WE assets/mud_bricks.xpm


1111111111111111
1011111110001001
1110001000111001
100001N100000001
1111001001111111
1111111111111111
1000000000000001 
1111111111111111