   NO assets/end_bricks.xpm
SO assets/SO.xpm
EA assets/EA.xpm

SKY 

	111111111111
 1111111100000000001
11000000000000000011
1000000000000000001
1111111111111111111