C assets/sky_powder.xpm
F assets/end_bricks.xpm
NO assets/end_bricks.xpm
SO assets/stonebrick_mossy.xpm
EA assets/stonebrick.xpm
WE assets/mud_bricks.xpm

111111111
111101111
100000001
1000N0001
111111111