F 0,153,51
C 255,255,204
NO assets/end_bricks.xpm
SO assets/stonebrick_mossy.xpm
EA assets/stonebrick.xpm
WE assets/mud_bricks.xpm
DD assets/test_door.xpm

1111111111111
1111101111111
1000101000001
1000000010001
10000E0000001
1000000000001
1000000000001
1000000000001
1000000000001
111111D111111
1000000000001
1000000000001
1111111111111
