S 255,255,255
F 213,52,123
NO assets/end_bricks.xpm
SO assets/SO.xpm
EA assets/EA.xpm


	1111111111111111
 1111111100000000001
11000000000000000001
1000000000000000001
1111111111111111111
1111111111111111
1000000000000001
1111111111111111