F 132,192,200
C 195,224,244
NO assets/end_bricks.xpm
SO assets/stonebrick_mossy.xpm
EA assets/stonebrick.xpm
WE assets/mud_bricks.xpm
DD assets/doors_dark_oak.xpm

1111111111111
1111101111111
1000101000001
1000000010001
10000E0000001
1000000000001
1000000000001
1000000000001
111111D1L1111
1000000000001
1010000000001
1010100000001
1001010100011
1000111010101
1000010001001
1111111111111
