C assets/sky_powder.xpm
F assets/end_bricks.xpm
NO assets/end_bricks.xpm
SO assets/stonebrick_mossy.xpm
EA assets/stonebrick.xpm
WE assets/mud_bricks.xpm

1111111111111
1111111111111
1000000000001
100000N000001
1111111111111