C assets/sky_powder.xpm
F assets/end_bricks.xpm
NO assets/end_bricks.xpm
SO assets/stonebrick_mossy.xpm
EA assets/stonebrick.xpm
WE assets/mud_bricks.xpm


1111111111111111
1E11111110001001
1110000000111001
1000000000000001
1111000001111111
1111111111111111
1000000000000001
1111111111111111