F 0,153,51
C 255,255,204
NO assets/end_bricks.xpm
SO assets/stonebrick_mossy.xpm
EA assets/stonebrick.xpm
WE assets/mud_bricks.xpm


        1111111111111111111111111
        1000000000110000000000001
        1001000001110000000000001
        1001000000000000000000001
111111111011000001110000000100001
100000000011000001110111110111111
11110111111111011100000010001
111111111111111111111111111111
                                 11111111111
                                 111111111111
                                  11111111
11111111111111111111111111111111
10000000000000000000000000000001
10000000000000000000000000000001
1000000000000000N000000000000001
10000000000000000000000000000001
10000000000000000000000000000001
10000000000000000000000000000001
11111111111111111111111111111111
